"filename", "language", "C", "LinkerScript", "Assembler file", "XML", "comment", "blank", "total"
"y:\RAMworkspace\F4Z_test\App_fxsh\inc\fxsh.h", "C", 19, 0, 0, 0, 14, 2, 35
"y:\RAMworkspace\F4Z_test\App_fxsh\inc\fxsh_api.h", "C", 89, 0, 0, 0, 23, 8, 120
"y:\RAMworkspace\F4Z_test\App_fxsh\src\fxsh.c", "C", 132, 0, 0, 0, 66, 15, 213
"y:\RAMworkspace\F4Z_test\App_fxsh\src\sh_cmd_echo.c", "C", 79, 0, 0, 0, 22, 6, 107
"y:\RAMworkspace\F4Z_test\App_fxsh\src\sh_cmd_help.c", "C", 64, 0, 0, 0, 22, 4, 90
"y:\RAMworkspace\F4Z_test\App_fxsh\src\sh_cmd_history.c", "C", 37, 0, 0, 0, 17, 3, 57
"y:\RAMworkspace\F4Z_test\App_fxsh\src\sh_fx_cat.c", "C", 53, 0, 0, 0, 19, 6, 78
"y:\RAMworkspace\F4Z_test\App_fxsh\src\sh_fx_cd.c", "C", 123, 0, 0, 0, 27, 11, 161
"y:\RAMworkspace\F4Z_test\App_fxsh\src\sh_fx_check.c", "C", 16, 0, 0, 0, 17, 2, 35
"y:\RAMworkspace\F4Z_test\App_fxsh\src\sh_fx_date.c", "C", 87, 0, 0, 0, 17, 4, 108
"y:\RAMworkspace\F4Z_test\App_fxsh\src\sh_fx_deinit.c", "C", 27, 0, 0, 0, 17, 2, 46
"y:\RAMworkspace\F4Z_test\App_fxsh\src\sh_fx_df.c", "C", 70, 0, 0, 0, 18, 5, 93
"y:\RAMworkspace\F4Z_test\App_fxsh\src\sh_fx_find.c", "C", 24, 0, 0, 0, 17, 7, 48
"y:\RAMworkspace\F4Z_test\App_fxsh\src\sh_fx_format.c", "C", 44, 0, 0, 0, 18, 2, 64
"y:\RAMworkspace\F4Z_test\App_fxsh\src\sh_fx_init.c", "C", 48, 0, 0, 0, 17, 6, 71
"y:\RAMworkspace\F4Z_test\App_fxsh\src\sh_fx_ls.c", "C", 58, 0, 0, 0, 18, 6, 82
"y:\RAMworkspace\F4Z_test\App_fxsh\src\sh_fx_mkdir.c", "C", 107, 0, 0, 0, 27, 8, 142
"y:\RAMworkspace\F4Z_test\App_fxsh\src\sh_fx_mv.c", "C", 23, 0, 0, 0, 18, 3, 44
"y:\RAMworkspace\F4Z_test\App_fxsh\src\sh_fx_pwd.c", "C", 49, 0, 0, 0, 21, 6, 76
"y:\RAMworkspace\F4Z_test\App_fxsh\src\sh_fx_rm.c", "C", 72, 0, 0, 0, 21, 6, 99
"y:\RAMworkspace\F4Z_test\App_fxsh\src\sh_fx_test.c", "C", 27, 0, 0, 0, 17, 1, 45
"y:\RAMworkspace\F4Z_test\App_fxsh\src\sh_fx_time.c", "C", 87, 0, 0, 0, 17, 4, 108
"y:\RAMworkspace\F4Z_test\App_fxsh\src\sh_fx_touch.c", "C", 77, 0, 0, 0, 23, 7, 107
"y:\RAMworkspace\F4Z_test\App_fxsh\src\sh_fx_tree.c", "C", 25, 0, 0, 0, 18, 3, 46
"y:\RAMworkspace\F4Z_test\App_sd\inc\sd_api.h", "C", 46, 0, 0, 0, 17, 6, 69
"y:\RAMworkspace\F4Z_test\App_sd\inc\sd_com.h", "C", 15, 0, 0, 0, 15, 6, 36
"y:\RAMworkspace\F4Z_test\App_sd\inc\sd_dir.h", "C", 15, 0, 0, 0, 15, 7, 37
"y:\RAMworkspace\F4Z_test\App_sd\inc\sd_file.h", "C", 16, 0, 0, 0, 15, 8, 39
"y:\RAMworkspace\F4Z_test\App_sd\inc\sd_media.h", "C", 20, 0, 0, 0, 15, 2, 37
"y:\RAMworkspace\F4Z_test\App_sd\src\app_sd.c", "C", 5, 0, 0, 0, 17, 2, 24
"y:\RAMworkspace\F4Z_test\App_sd\src\sd_com_delete.c", "C", 241, 0, 0, 0, 55, 20, 316
"y:\RAMworkspace\F4Z_test\App_sd\src\sd_com_find.c", "C", 109, 0, 0, 0, 23, 13, 145
"y:\RAMworkspace\F4Z_test\App_sd\src\sd_com_list.c", "C", 142, 0, 0, 0, 51, 19, 212
"y:\RAMworkspace\F4Z_test\App_sd\src\sd_com_move.c", "C", 29, 0, 0, 0, 23, 5, 57
"y:\RAMworkspace\F4Z_test\App_sd\src\sd_com_tree.1.c", "C", 160, 0, 0, 0, 37, 19, 216
"y:\RAMworkspace\F4Z_test\App_sd\src\sd_com_tree.c", "C", 0, 0, 0, 0, 231, 22, 253
"y:\RAMworkspace\F4Z_test\App_sd\src\sd_dir_create.c", "C", 21, 0, 0, 0, 17, 2, 40
"y:\RAMworkspace\F4Z_test\App_sd\src\sd_dir_default.c", "C", 25, 0, 0, 0, 18, 5, 48
"y:\RAMworkspace\F4Z_test\App_sd\src\sd_dir_exist.c", "C", 5, 0, 0, 0, 17, 2, 24
"y:\RAMworkspace\F4Z_test\App_sd\src\sd_file_cat.c", "C", 102, 0, 0, 0, 24, 14, 140
"y:\RAMworkspace\F4Z_test\App_sd\src\sd_file_create.c", "C", 23, 0, 0, 0, 17, 2, 42
"y:\RAMworkspace\F4Z_test\App_sd\src\sd_file_read.c", "C", 28, 0, 0, 0, 18, 6, 52
"y:\RAMworkspace\F4Z_test\App_sd\src\sd_file_set_attribute.c", "C", 21, 0, 0, 0, 17, 2, 40
"y:\RAMworkspace\F4Z_test\App_sd\src\sd_file_write.c", "C", 40, 0, 0, 0, 26, 7, 73
"y:\RAMworkspace\F4Z_test\App_sd\src\sd_media_abort.c", "C", 5, 0, 0, 0, 17, 2, 24
"y:\RAMworkspace\F4Z_test\App_sd\src\sd_media_close.c", "C", 18, 0, 0, 0, 24, 3, 45
"y:\RAMworkspace\F4Z_test\App_sd\src\sd_media_format.c", "C", 119, 0, 0, 0, 29, 9, 157
"y:\RAMworkspace\F4Z_test\App_sd\src\sd_media_open.c", "C", 11, 0, 0, 0, 22, 2, 35
"y:\RAMworkspace\F4Z_test\App_sd\src\sd_media_space.c", "C", 36, 0, 0, 0, 36, 10, 82
"y:\RAMworkspace\F4Z_test\App_sd\src\sd_media_test.c", "C", 177, 0, 0, 0, 42, 17, 236
"y:\RAMworkspace\F4Z_test\App_sd\src\sd_media_volume.c", "C", 28, 0, 0, 0, 29, 3, 60
"y:\RAMworkspace\F4Z_test\App_sd\src\sd_meida_check.c", "C", 47, 0, 0, 0, 21, 10, 78
"y:\RAMworkspace\F4Z_test\Core\Inc\RTE_Components.h", "C", 5, 0, 0, 0, 22, 3, 30
"y:\RAMworkspace\F4Z_test\Core\Inc\dma.h", "C", 11, 0, 0, 0, 28, 14, 53
"y:\RAMworkspace\F4Z_test\Core\Inc\fsmc.h", "C", 14, 0, 0, 0, 33, 13, 60
"y:\RAMworkspace\F4Z_test\Core\Inc\gpio.h", "C", 11, 0, 0, 0, 27, 12, 50
"y:\RAMworkspace\F4Z_test\Core\Inc\main.h", "C", 17, 0, 0, 0, 39, 19, 75
"y:\RAMworkspace\F4Z_test\Core\Inc\sdio.h", "C", 12, 0, 0, 0, 27, 14, 53
"y:\RAMworkspace\F4Z_test\Core\Inc\stm32f4xx_hal_conf.h", "C", 277, 0, 0, 0, 133, 86, 496
"y:\RAMworkspace\F4Z_test\Core\Inc\stm32f4xx_it.h", "C", 22, 0, 0, 0, 34, 15, 71
"y:\RAMworkspace\F4Z_test\Core\Inc\tim.h", "C", 12, 0, 0, 0, 27, 14, 53
"y:\RAMworkspace\F4Z_test\Core\Inc\usart.h", "C", 12, 0, 0, 0, 27, 14, 53
"y:\RAMworkspace\F4Z_test\Core\Src\dma.c", "C", 9, 0, 0, 0, 36, 14, 59
"y:\RAMworkspace\F4Z_test\Core\Src\fsmc.c", "C", 98, 0, 0, 0, 148, 45, 291
"y:\RAMworkspace\F4Z_test\Core\Src\gpio.c", "C", 19, 0, 0, 0, 40, 15, 74
"y:\RAMworkspace\F4Z_test\Core\Src\main.c", "C", 71, 0, 0, 0, 93, 37, 201
"y:\RAMworkspace\F4Z_test\Core\Src\sdio.c", "C", 117, 0, 0, 0, 63, 31, 211
"y:\RAMworkspace\F4Z_test\Core\Src\stm32f4xx_hal_msp.c", "C", 6, 0, 0, 0, 52, 25, 83
"y:\RAMworkspace\F4Z_test\Core\Src\stm32f4xx_it.c", "C", 73, 0, 0, 0, 145, 45, 263
"y:\RAMworkspace\F4Z_test\Core\Src\syscalls.c", "C", 123, 0, 0, 0, 25, 29, 177
"y:\RAMworkspace\F4Z_test\Core\Src\sysmem.c", "C", 24, 0, 0, 0, 48, 8, 80
"y:\RAMworkspace\F4Z_test\Core\Src\system_stm32f4xx.c", "C", 346, 0, 0, 0, 319, 83, 748
"y:\RAMworkspace\F4Z_test\Core\Src\tim.c", "C", 32, 0, 0, 0, 43, 23, 98
"y:\RAMworkspace\F4Z_test\Core\Src\usart.c", "C", 112, 0, 0, 0, 51, 32, 195
"y:\RAMworkspace\F4Z_test\Core\Startup\startup_stm32f407zgtx.s", "Assembler file", 0, 0, 398, 0, 0, 111, 509
"y:\RAMworkspace\F4Z_test\F4Z_test Debug.launch", "XML", 0, 0, 0, 83, 0, 1, 84
"y:\RAMworkspace\F4Z_test\FileX\App\app_filex.c", "C", 74, 0, 0, 0, 49, 20, 143
"y:\RAMworkspace\F4Z_test\FileX\App\app_filex.h", "C", 14, 0, 0, 0, 41, 17, 72
"y:\RAMworkspace\F4Z_test\FileX\App\fx_user.h", "C", 4, 0, 0, 0, 140, 69, 213
"y:\RAMworkspace\F4Z_test\FileX\Target\fx_stm32_sd_driver.h", "C", 62, 0, 0, 0, 76, 68, 206
"y:\RAMworkspace\F4Z_test\FileX\Target\fx_stm32_sd_driver_glue.c", "C", 64, 0, 0, 0, 81, 42, 187
"y:\RAMworkspace\F4Z_test\Middlewares\ST\filex\common\drivers\fx_stm32_sd_driver.c", "C", 261, 0, 0, 0, 71, 80, 412
"y:\RAMworkspace\F4Z_test\Middlewares\ST\filex\common\inc\fx_api.h", "C", 1062, 0, 0, 0, 292, 318, 1672
"y:\RAMworkspace\F4Z_test\Middlewares\ST\filex\common\inc\fx_directory.h", "C", 75, 0, 0, 0, 46, 17, 138
"y:\RAMworkspace\F4Z_test\Middlewares\ST\filex\common\inc\fx_directory_exFAT.h", "C", 49, 0, 0, 0, 58, 55, 162
"y:\RAMworkspace\F4Z_test\Middlewares\ST\filex\common\inc\fx_fault_tolerant.h", "C", 135, 0, 0, 0, 222, 58, 415
"y:\RAMworkspace\F4Z_test\Middlewares\ST\filex\common\inc\fx_file.h", "C", 67, 0, 0, 0, 47, 12, 126
"y:\RAMworkspace\F4Z_test\Middlewares\ST\filex\common\inc\fx_media.h", "C", 53, 0, 0, 0, 46, 16, 115
"y:\RAMworkspace\F4Z_test\Middlewares\ST\filex\common\inc\fx_system.h", "C", 31, 0, 0, 0, 102, 43, 176
"y:\RAMworkspace\F4Z_test\Middlewares\ST\filex\common\inc\fx_unicode.h", "C", 46, 0, 0, 0, 47, 18, 111
"y:\RAMworkspace\F4Z_test\Middlewares\ST\filex\common\inc\fx_user_sample.h", "C", 7, 0, 0, 0, 146, 109, 262
"y:\RAMworkspace\F4Z_test\Middlewares\ST\filex\common\inc\fx_utility.h", "C", 54, 0, 0, 0, 52, 21, 127
"y:\RAMworkspace\F4Z_test\Middlewares\ST\filex\common\src\fx_directory_attributes_read.c", "C", 41, 0, 0, 0, 84, 32, 157
"y:\RAMworkspace\F4Z_test\Middlewares\ST\filex\common\src\fx_directory_attributes_set.c", "C", 69, 0, 0, 0, 97, 40, 206
"y:\RAMworkspace\F4Z_test\Middlewares\ST\filex\common\src\fx_directory_create.c", "C", 433, 0, 0, 0, 264, 208, 905
"y:\RAMworkspace\F4Z_test\Middlewares\ST\filex\common\src\fx_directory_default_get.c", "C", 18, 0, 0, 0, 70, 19, 107
"y:\RAMworkspace\F4Z_test\Middlewares\ST\filex\common\src\fx_directory_default_get_copy.c", "C", 24, 0, 0, 0, 73, 18, 115
"y:\RAMworkspace\F4Z_test\Middlewares\ST\filex\common\src\fx_directory_default_set.c", "C", 197, 0, 0, 0, 158, 99, 454
"y:\RAMworkspace\F4Z_test\Middlewares\ST\filex\common\src\fx_directory_delete.c", "C", 300, 0, 0, 0, 163, 127, 590
"y:\RAMworkspace\F4Z_test\Middlewares\ST\filex\common\src\fx_directory_entry_read.c", "C", 378, 0, 0, 0, 242, 167, 787
"y:\RAMworkspace\F4Z_test\Middlewares\ST\filex\common\src\fx_directory_entry_write.c", "C", 607, 0, 0, 0, 308, 238, 1153
"y:\RAMworkspace\F4Z_test\Middlewares\ST\filex\common\src\fx_directory_exFAT_entry_read.c", "C", 343, 0, 0, 0, 221, 155, 719
"y:\RAMworkspace\F4Z_test\Middlewares\ST\filex\common\src\fx_directory_exFAT_entry_write.c", "C", 11, 0, 0, 0, 77, 15, 103
"y:\RAMworkspace\F4Z_test\Middlewares\ST\filex\common\src\fx_directory_exFAT_free_search.c", "C", 237, 0, 0, 0, 173, 107, 517
"y:\RAMworkspace\F4Z_test\Middlewares\ST\filex\common\src\fx_directory_exFAT_unicode_entry_write.c", "C", 478, 0, 0, 0, 268, 201, 947
"y:\RAMworkspace\F4Z_test\Middlewares\ST\filex\common\src\fx_directory_first_entry_find.c", "C", 36, 0, 0, 0, 75, 26, 137
"y:\RAMworkspace\F4Z_test\Middlewares\ST\filex\common\src\fx_directory_first_full_entry_find.c", "C", 39, 0, 0, 0, 83, 25, 147
"y:\RAMworkspace\F4Z_test\Middlewares\ST\filex\common\src\fx_directory_free_search.c", "C", 385, 0, 0, 0, 240, 154, 779
"y:\RAMworkspace\F4Z_test\Middlewares\ST\filex\common\src\fx_directory_information_get.c", "C", 82, 0, 0, 0, 108, 46, 236
"y:\RAMworkspace\F4Z_test\Middlewares\ST\filex\common\src\fx_directory_local_path_clear.c", "C", 26, 0, 0, 0, 68, 21, 115
"y:\RAMworkspace\F4Z_test\Middlewares\ST\filex\common\src\fx_directory_local_path_get.c", "C", 34, 0, 0, 0, 73, 23, 130
"y:\RAMworkspace\F4Z_test\Middlewares\ST\filex\common\src\fx_directory_local_path_get_copy.c", "C", 33, 0, 0, 0, 72, 19, 124
"y:\RAMworkspace\F4Z_test\Middlewares\ST\filex\common\src\fx_directory_local_path_restore.c", "C", 27, 0, 0, 0, 70, 21, 118
"y:\RAMworkspace\F4Z_test\Middlewares\ST\filex\common\src\fx_directory_local_path_set.c", "C", 188, 0, 0, 0, 164, 100, 452
"y:\RAMworkspace\F4Z_test\Middlewares\ST\filex\common\src\fx_directory_long_name_get.c", "C", 7, 0, 0, 0, 68, 11, 86
"y:\RAMworkspace\F4Z_test\Middlewares\ST\filex\common\src\fx_directory_long_name_get_extended.c", "C", 32, 0, 0, 0, 80, 28, 140
"y:\RAMworkspace\F4Z_test\Middlewares\ST\filex\common\src\fx_directory_name_extract.c", "C", 47, 0, 0, 0, 84, 31, 162
"y:\RAMworkspace\F4Z_test\Middlewares\ST\filex\common\src\fx_directory_name_test.c", "C", 35, 0, 0, 0, 80, 29, 144
"y:\RAMworkspace\F4Z_test\Middlewares\ST\filex\common\src\fx_directory_next_entry_find.c", "C", 220, 0, 0, 0, 151, 101, 472
"y:\RAMworkspace\F4Z_test\Middlewares\ST\filex\common\src\fx_directory_next_full_entry_find.c", "C", 274, 0, 0, 0, 179, 121, 574
"y:\RAMworkspace\F4Z_test\Middlewares\ST\filex\common\src\fx_directory_rename.c", "C", 247, 0, 0, 0, 164, 113, 524
"y:\RAMworkspace\F4Z_test\Middlewares\ST\filex\common\src\fx_directory_search.c", "C", 492, 0, 0, 0, 289, 204, 985
"y:\RAMworkspace\F4Z_test\Middlewares\ST\filex\common\src\fx_directory_short_name_get.c", "C", 7, 0, 0, 0, 68, 11, 86
"y:\RAMworkspace\F4Z_test\Middlewares\ST\filex\common\src\fx_directory_short_name_get_extended.c", "C", 49, 0, 0, 0, 87, 35, 171
"y:\RAMworkspace\F4Z_test\Middlewares\ST\filex\common\src\fx_fault_tolerant_add_FAT_log.c", "C", 27, 0, 0, 0, 70, 17, 114
"y:\RAMworkspace\F4Z_test\Middlewares\ST\filex\common\src\fx_fault_tolerant_add_bitmap_log.c", "C", 27, 0, 0, 0, 71, 17, 115
"y:\RAMworkspace\F4Z_test\Middlewares\ST\filex\common\src\fx_fault_tolerant_add_checksum_log.c", "C", 46, 0, 0, 0, 84, 26, 156
"y:\RAMworkspace\F4Z_test\Middlewares\ST\filex\common\src\fx_fault_tolerant_add_dir_log.c", "C", 35, 0, 0, 0, 78, 21, 134
"y:\RAMworkspace\F4Z_test\Middlewares\ST\filex\common\src\fx_fault_tolerant_apply_logs.c", "C", 152, 0, 0, 0, 118, 66, 336
"y:\RAMworkspace\F4Z_test\Middlewares\ST\filex\common\src\fx_fault_tolerant_calculate_checksum.c", "C", 21, 0, 0, 0, 69, 14, 104
"y:\RAMworkspace\F4Z_test\Middlewares\ST\filex\common\src\fx_fault_tolerant_cleanup_FAT_chain.c", "C", 127, 0, 0, 0, 119, 47, 293
"y:\RAMworkspace\F4Z_test\Middlewares\ST\filex\common\src\fx_fault_tolerant_create_log_file.c", "C", 208, 0, 0, 0, 133, 75, 416
"y:\RAMworkspace\F4Z_test\Middlewares\ST\filex\common\src\fx_fault_tolerant_enable.c", "C", 236, 0, 0, 0, 174, 110, 520
"y:\RAMworkspace\F4Z_test\Middlewares\ST\filex\common\src\fx_fault_tolerant_read_FAT.c", "C", 70, 0, 0, 0, 91, 33, 194
"y:\RAMworkspace\F4Z_test\Middlewares\ST\filex\common\src\fx_fault_tolerant_read_directory_sector.c", "C", 60, 0, 0, 0, 88, 31, 179
"y:\RAMworkspace\F4Z_test\Middlewares\ST\filex\common\src\fx_fault_tolerant_read_log_file.c", "C", 20, 0, 0, 0, 62, 12, 94
"y:\RAMworkspace\F4Z_test\Middlewares\ST\filex\common\src\fx_fault_tolerant_recover.c", "C", 45, 0, 0, 0, 98, 26, 169
"y:\RAMworkspace\F4Z_test\Middlewares\ST\filex\common\src\fx_fault_tolerant_reset_log_file.c", "C", 42, 0, 0, 0, 85, 16, 143
"y:\RAMworkspace\F4Z_test\Middlewares\ST\filex\common\src\fx_fault_tolerant_set_FAT_chain.c", "C", 36, 0, 0, 0, 81, 17, 134
"y:\RAMworkspace\F4Z_test\Middlewares\ST\filex\common\src\fx_fault_tolerant_transaction_end.c", "C", 65, 0, 0, 0, 112, 31, 208
"y:\RAMworkspace\F4Z_test\Middlewares\ST\filex\common\src\fx_fault_tolerant_transaction_fail.c", "C", 18, 0, 0, 0, 77, 11, 106
"y:\RAMworkspace\F4Z_test\Middlewares\ST\filex\common\src\fx_fault_tolerant_transaction_start.c", "C", 21, 0, 0, 0, 80, 15, 116
"y:\RAMworkspace\F4Z_test\Middlewares\ST\filex\common\src\fx_fault_tolerant_write_log_file.c", "C", 26, 0, 0, 0, 71, 16, 113
"y:\RAMworkspace\F4Z_test\Middlewares\ST\filex\common\src\fx_file_allocate.c", "C", 9, 0, 0, 0, 66, 10, 85
"y:\RAMworkspace\F4Z_test\Middlewares\ST\filex\common\src\fx_file_attributes_read.c", "C", 54, 0, 0, 0, 83, 33, 170
"y:\RAMworkspace\F4Z_test\Middlewares\ST\filex\common\src\fx_file_attributes_set.c", "C", 96, 0, 0, 0, 103, 45, 244
"y:\RAMworkspace\F4Z_test\Middlewares\ST\filex\common\src\fx_file_best_effort_allocate.c", "C", 14, 0, 0, 0, 70, 14, 98
"y:\RAMworkspace\F4Z_test\Middlewares\ST\filex\common\src\fx_file_close.c", "C", 71, 0, 0, 0, 89, 39, 199
"y:\RAMworkspace\F4Z_test\Middlewares\ST\filex\common\src\fx_file_create.c", "C", 174, 0, 0, 0, 138, 81, 393
"y:\RAMworkspace\F4Z_test\Middlewares\ST\filex\common\src\fx_file_date_time_set.c", "C", 40, 0, 0, 0, 83, 26, 149
"y:\RAMworkspace\F4Z_test\Middlewares\ST\filex\common\src\fx_file_delete.c", "C", 240, 0, 0, 0, 143, 95, 478
"y:\RAMworkspace\F4Z_test\Middlewares\ST\filex\common\src\fx_file_extended_allocate.c", "C", 482, 0, 0, 0, 217, 173, 872
"y:\RAMworkspace\F4Z_test\Middlewares\ST\filex\common\src\fx_file_extended_best_effort_allocate.c", "C", 504, 0, 0, 0, 229, 186, 919
"y:\RAMworkspace\F4Z_test\Middlewares\ST\filex\common\src\fx_file_extended_relative_seek.c", "C", 49, 0, 0, 0, 89, 26, 164
"y:\RAMworkspace\F4Z_test\Middlewares\ST\filex\common\src\fx_file_extended_seek.c", "C", 147, 0, 0, 0, 114, 68, 329
"y:\RAMworkspace\F4Z_test\Middlewares\ST\filex\common\src\fx_file_extended_truncate.c", "C", 177, 0, 0, 0, 127, 74, 378
"y:\RAMworkspace\F4Z_test\Middlewares\ST\filex\common\src\fx_file_extended_truncate_release.c", "C", 530, 0, 0, 0, 240, 204, 974
"y:\RAMworkspace\F4Z_test\Middlewares\ST\filex\common\src\fx_file_open.c", "C", 330, 0, 0, 0, 167, 110, 607
"y:\RAMworkspace\F4Z_test\Middlewares\ST\filex\common\src\fx_file_read.c", "C", 216, 0, 0, 0, 159, 89, 464
"y:\RAMworkspace\F4Z_test\Middlewares\ST\filex\common\src\fx_file_relative_seek.c", "C", 9, 0, 0, 0, 71, 11, 91
"y:\RAMworkspace\F4Z_test\Middlewares\ST\filex\common\src\fx_file_rename.c", "C", 296, 0, 0, 0, 176, 127, 599
"y:\RAMworkspace\F4Z_test\Middlewares\ST\filex\common\src\fx_file_seek.c", "C", 9, 0, 0, 0, 65, 10, 84
"y:\RAMworkspace\F4Z_test\Middlewares\ST\filex\common\src\fx_file_truncate.c", "C", 9, 0, 0, 0, 65, 10, 84
"y:\RAMworkspace\F4Z_test\Middlewares\ST\filex\common\src\fx_file_truncate_release.c", "C", 9, 0, 0, 0, 67, 11, 87
"y:\RAMworkspace\F4Z_test\Middlewares\ST\filex\common\src\fx_file_write.c", "C", 1035, 0, 0, 0, 388, 348, 1771
"y:\RAMworkspace\F4Z_test\Middlewares\ST\filex\common\src\fx_file_write_notify_set.c", "C", 8, 0, 0, 0, 64, 12, 84
"y:\RAMworkspace\F4Z_test\Middlewares\ST\filex\common\src\fx_media_abort.c", "C", 61, 0, 0, 0, 89, 40, 190
"y:\RAMworkspace\F4Z_test\Middlewares\ST\filex\common\src\fx_media_boot_info_extract.c", "C", 147, 0, 0, 0, 131, 54, 332
"y:\RAMworkspace\F4Z_test\Middlewares\ST\filex\common\src\fx_media_cache_invalidate.c", "C", 32, 0, 0, 0, 77, 26, 135
"y:\RAMworkspace\F4Z_test\Middlewares\ST\filex\common\src\fx_media_check.c", "C", 368, 0, 0, 0, 289, 174, 831
"y:\RAMworkspace\F4Z_test\Middlewares\ST\filex\common\src\fx_media_check_FAT_chain_check.c", "C", 52, 0, 0, 0, 88, 32, 172
"y:\RAMworkspace\F4Z_test\Middlewares\ST\filex\common\src\fx_media_check_lost_cluster_check.c", "C", 98, 0, 0, 0, 141, 44, 283
"y:\RAMworkspace\F4Z_test\Middlewares\ST\filex\common\src\fx_media_close.c", "C", 183, 0, 0, 0, 164, 101, 448
"y:\RAMworkspace\F4Z_test\Middlewares\ST\filex\common\src\fx_media_close_notify_set.c", "C", 8, 0, 0, 0, 63, 12, 83
"y:\RAMworkspace\F4Z_test\Middlewares\ST\filex\common\src\fx_media_exFAT_format.c", "C", 759, 0, 0, 0, 263, 210, 1232
"y:\RAMworkspace\F4Z_test\Middlewares\ST\filex\common\src\fx_media_extended_space_available.c", "C", 22, 0, 0, 0, 72, 22, 116
"y:\RAMworkspace\F4Z_test\Middlewares\ST\filex\common\src\fx_media_flush.c", "C", 152, 0, 0, 0, 139, 83, 374
"y:\RAMworkspace\F4Z_test\Middlewares\ST\filex\common\src\fx_media_format.c", "C", 322, 0, 0, 0, 223, 147, 692
"y:\RAMworkspace\F4Z_test\Middlewares\ST\filex\common\src\fx_media_format_oem_name_set.c", "C", 14, 0, 0, 0, 67, 17, 98
"y:\RAMworkspace\F4Z_test\Middlewares\ST\filex\common\src\fx_media_format_type_set.c", "C", 10, 0, 0, 0, 65, 14, 89
"y:\RAMworkspace\F4Z_test\Middlewares\ST\filex\common\src\fx_media_format_volume_id_set.c", "C", 10, 0, 0, 0, 66, 13, 89
"y:\RAMworkspace\F4Z_test\Middlewares\ST\filex\common\src\fx_media_open.c", "C", 541, 0, 0, 0, 319, 200, 1060
"y:\RAMworkspace\F4Z_test\Middlewares\ST\filex\common\src\fx_media_open_notify_set.c", "C", 8, 0, 0, 0, 63, 12, 83
"y:\RAMworkspace\F4Z_test\Middlewares\ST\filex\common\src\fx_media_read.c", "C", 31, 0, 0, 0, 72, 25, 128
"y:\RAMworkspace\F4Z_test\Middlewares\ST\filex\common\src\fx_media_space_available.c", "C", 22, 0, 0, 0, 70, 16, 108
"y:\RAMworkspace\F4Z_test\Middlewares\ST\filex\common\src\fx_media_volume_get.c", "C", 13, 0, 0, 0, 69, 11, 93
"y:\RAMworkspace\F4Z_test\Middlewares\ST\filex\common\src\fx_media_volume_get_extended.c", "C", 159, 0, 0, 0, 133, 84, 376
"y:\RAMworkspace\F4Z_test\Middlewares\ST\filex\common\src\fx_media_volume_set.c", "C", 250, 0, 0, 0, 183, 132, 565
"y:\RAMworkspace\F4Z_test\Middlewares\ST\filex\common\src\fx_media_write.c", "C", 36, 0, 0, 0, 75, 28, 139
"y:\RAMworkspace\F4Z_test\Middlewares\ST\filex\common\src\fx_partition_offset_calculate.c", "C", 123, 0, 0, 0, 164, 59, 346
"y:\RAMworkspace\F4Z_test\Middlewares\ST\filex\common\src\fx_system_date_get.c", "C", 25, 0, 0, 0, 74, 21, 120
"y:\RAMworkspace\F4Z_test\Middlewares\ST\filex\common\src\fx_system_date_set.c", "C", 10, 0, 0, 0, 65, 14, 89
"y:\RAMworkspace\F4Z_test\Middlewares\ST\filex\common\src\fx_system_initialize.c", "C", 106, 0, 0, 0, 77, 25, 208
"y:\RAMworkspace\F4Z_test\Middlewares\ST\filex\common\src\fx_system_time_get.c", "C", 25, 0, 0, 0, 74, 21, 120
"y:\RAMworkspace\F4Z_test\Middlewares\ST\filex\common\src\fx_system_time_set.c", "C", 10, 0, 0, 0, 65, 14, 89
"y:\RAMworkspace\F4Z_test\Middlewares\ST\filex\common\src\fx_system_timer_entry.c", "C", 170, 0, 0, 0, 106, 68, 344
"y:\RAMworkspace\F4Z_test\Middlewares\ST\filex\common\src\fx_unicode_directory_create.c", "C", 112, 0, 0, 0, 120, 60, 292
"y:\RAMworkspace\F4Z_test\Middlewares\ST\filex\common\src\fx_unicode_directory_entry_change.c", "C", 184, 0, 0, 0, 127, 80, 391
"y:\RAMworkspace\F4Z_test\Middlewares\ST\filex\common\src\fx_unicode_directory_entry_read.c", "C", 351, 0, 0, 0, 239, 159, 749
"y:\RAMworkspace\F4Z_test\Middlewares\ST\filex\common\src\fx_unicode_directory_rename.c", "C", 145, 0, 0, 0, 135, 74, 354
"y:\RAMworkspace\F4Z_test\Middlewares\ST\filex\common\src\fx_unicode_directory_search.c", "C", 261, 0, 0, 0, 154, 87, 502
"y:\RAMworkspace\F4Z_test\Middlewares\ST\filex\common\src\fx_unicode_file_create.c", "C", 113, 0, 0, 0, 120, 60, 293
"y:\RAMworkspace\F4Z_test\Middlewares\ST\filex\common\src\fx_unicode_file_rename.c", "C", 146, 0, 0, 0, 137, 71, 354
"y:\RAMworkspace\F4Z_test\Middlewares\ST\filex\common\src\fx_unicode_length_get.c", "C", 7, 0, 0, 0, 64, 11, 82
"y:\RAMworkspace\F4Z_test\Middlewares\ST\filex\common\src\fx_unicode_length_get_extended.c", "C", 21, 0, 0, 0, 65, 18, 104
"y:\RAMworkspace\F4Z_test\Middlewares\ST\filex\common\src\fx_unicode_name_get.c", "C", 8, 0, 0, 0, 69, 11, 88
"y:\RAMworkspace\F4Z_test\Middlewares\ST\filex\common\src\fx_unicode_name_get_extended.c", "C", 37, 0, 0, 0, 80, 29, 146
"y:\RAMworkspace\F4Z_test\Middlewares\ST\filex\common\src\fx_unicode_short_name_get.c", "C", 8, 0, 0, 0, 69, 11, 88
"y:\RAMworkspace\F4Z_test\Middlewares\ST\filex\common\src\fx_unicode_short_name_get_extended.c", "C", 29, 0, 0, 0, 77, 25, 131
"y:\RAMworkspace\F4Z_test\Middlewares\ST\filex\common\src\fx_utility_16_unsigned_read.c", "C", 11, 0, 0, 0, 62, 13, 86
"y:\RAMworkspace\F4Z_test\Middlewares\ST\filex\common\src\fx_utility_16_unsigned_write.c", "C", 9, 0, 0, 0, 62, 11, 82
"y:\RAMworkspace\F4Z_test\Middlewares\ST\filex\common\src\fx_utility_32_unsigned_read.c", "C", 13, 0, 0, 0, 62, 13, 88
"y:\RAMworkspace\F4Z_test\Middlewares\ST\filex\common\src\fx_utility_32_unsigned_write.c", "C", 11, 0, 0, 0, 62, 11, 84
"y:\RAMworkspace\F4Z_test\Middlewares\ST\filex\common\src\fx_utility_64_unsigned_read.c", "C", 15, 0, 0, 0, 61, 15, 91
"y:\RAMworkspace\F4Z_test\Middlewares\ST\filex\common\src\fx_utility_64_unsigned_write.c", "C", 9, 0, 0, 0, 62, 11, 82
"y:\RAMworkspace\F4Z_test\Middlewares\ST\filex\common\src\fx_utility_FAT_entry_read.c", "C", 202, 0, 0, 0, 150, 94, 446
"y:\RAMworkspace\F4Z_test\Middlewares\ST\filex\common\src\fx_utility_FAT_entry_write.c", "C", 99, 0, 0, 0, 113, 54, 266
"y:\RAMworkspace\F4Z_test\Middlewares\ST\filex\common\src\fx_utility_FAT_flush.c", "C", 262, 0, 0, 0, 183, 120, 565
"y:\RAMworkspace\F4Z_test\Middlewares\ST\filex\common\src\fx_utility_FAT_map_flush.c", "C", 57, 0, 0, 0, 86, 30, 173
"y:\RAMworkspace\F4Z_test\Middlewares\ST\filex\common\src\fx_utility_FAT_sector_get.c", "C", 31, 0, 0, 0, 68, 21, 120
"y:\RAMworkspace\F4Z_test\Middlewares\ST\filex\common\src\fx_utility_absolute_path_get.c", "C", 103, 0, 0, 0, 103, 49, 255
"y:\RAMworkspace\F4Z_test\Middlewares\ST\filex\common\src\fx_utility_exFAT_allocate_new_cluster.c", "C", 89, 0, 0, 0, 99, 45, 233
"y:\RAMworkspace\F4Z_test\Middlewares\ST\filex\common\src\fx_utility_exFAT_bitmap_cache_prepare.c", "C", 29, 0, 0, 0, 70, 22, 121
"y:\RAMworkspace\F4Z_test\Middlewares\ST\filex\common\src\fx_utility_exFAT_bitmap_cache_update.c", "C", 27, 0, 0, 0, 64, 17, 108
"y:\RAMworkspace\F4Z_test\Middlewares\ST\filex\common\src\fx_utility_exFAT_bitmap_flush.c", "C", 31, 0, 0, 0, 65, 20, 116
"y:\RAMworkspace\F4Z_test\Middlewares\ST\filex\common\src\fx_utility_exFAT_bitmap_free_cluster_find.c", "C", 47, 0, 0, 0, 81, 34, 162
"y:\RAMworkspace\F4Z_test\Middlewares\ST\filex\common\src\fx_utility_exFAT_bitmap_initialize.c", "C", 61, 0, 0, 0, 88, 38, 187
"y:\RAMworkspace\F4Z_test\Middlewares\ST\filex\common\src\fx_utility_exFAT_bitmap_start_sector_get.c", "C", 49, 0, 0, 0, 77, 28, 154
"y:\RAMworkspace\F4Z_test\Middlewares\ST\filex\common\src\fx_utility_exFAT_cluster_free.c", "C", 74, 0, 0, 0, 97, 45, 216
"y:\RAMworkspace\F4Z_test\Middlewares\ST\filex\common\src\fx_utility_exFAT_cluster_state_get.c", "C", 51, 0, 0, 0, 81, 26, 158
"y:\RAMworkspace\F4Z_test\Middlewares\ST\filex\common\src\fx_utility_exFAT_cluster_state_set.c", "C", 45, 0, 0, 0, 76, 26, 147
"y:\RAMworkspace\F4Z_test\Middlewares\ST\filex\common\src\fx_utility_exFAT_geometry_check.c", "C", 141, 0, 0, 0, 115, 65, 321
"y:\RAMworkspace\F4Z_test\Middlewares\ST\filex\common\src\fx_utility_exFAT_name_hash_get.c", "C", 22, 0, 0, 0, 67, 21, 110
"y:\RAMworkspace\F4Z_test\Middlewares\ST\filex\common\src\fx_utility_exFAT_size_calculate.c", "C", 43, 0, 0, 0, 85, 30, 158
"y:\RAMworkspace\F4Z_test\Middlewares\ST\filex\common\src\fx_utility_exFAT_system_area_checksum_verify.c", "C", 73, 0, 0, 0, 99, 45, 217
"y:\RAMworkspace\F4Z_test\Middlewares\ST\filex\common\src\fx_utility_exFAT_system_area_checksum_write.c", "C", 29, 0, 0, 0, 67, 20, 116
"y:\RAMworkspace\F4Z_test\Middlewares\ST\filex\common\src\fx_utility_exFAT_system_area_format.c", "C", 92, 0, 0, 0, 102, 44, 238
"y:\RAMworkspace\F4Z_test\Middlewares\ST\filex\common\src\fx_utility_exFAT_system_sector_write.c", "C", 24, 0, 0, 0, 67, 14, 105
"y:\RAMworkspace\F4Z_test\Middlewares\ST\filex\common\src\fx_utility_exFAT_unicode_name_hash_get.c", "C", 25, 0, 0, 0, 70, 22, 117
"y:\RAMworkspace\F4Z_test\Middlewares\ST\filex\common\src\fx_utility_exFAT_upcase_table.c", "C", 144, 0, 0, 0, 78, 40, 262
"y:\RAMworkspace\F4Z_test\Middlewares\ST\filex\common\src\fx_utility_logical_sector_cache_entry_read.c", "C", 175, 0, 0, 0, 118, 67, 360
"y:\RAMworkspace\F4Z_test\Middlewares\ST\filex\common\src\fx_utility_logical_sector_flush.c", "C", 226, 0, 0, 0, 188, 109, 523
"y:\RAMworkspace\F4Z_test\Middlewares\ST\filex\common\src\fx_utility_logical_sector_read.c", "C", 267, 0, 0, 0, 211, 130, 608
"y:\RAMworkspace\F4Z_test\Middlewares\ST\filex\common\src\fx_utility_logical_sector_write.c", "C", 194, 0, 0, 0, 163, 88, 445
"y:\RAMworkspace\F4Z_test\Middlewares\ST\filex\common\src\fx_utility_memory_copy.c", "C", 10, 0, 0, 0, 66, 14, 90
"y:\RAMworkspace\F4Z_test\Middlewares\ST\filex\common\src\fx_utility_memory_set.c", "C", 13, 0, 0, 0, 66, 15, 94
"y:\RAMworkspace\F4Z_test\Middlewares\ST\filex\common\src\fx_utility_string_length_get.c", "C", 13, 0, 0, 0, 67, 15, 95
"y:\RAMworkspace\F4Z_test\Middlewares\ST\filex\common\src\fx_utility_token_length_get.c", "C", 15, 0, 0, 0, 64, 17, 96
"y:\RAMworkspace\F4Z_test\Middlewares\ST\filex\common\src\fxe_directory_attributes_read.c", "C", 15, 0, 0, 0, 67, 15, 97
"y:\RAMworkspace\F4Z_test\Middlewares\ST\filex\common\src\fxe_directory_attributes_set.c", "C", 19, 0, 0, 0, 68, 18, 105
"y:\RAMworkspace\F4Z_test\Middlewares\ST\filex\common\src\fxe_directory_create.c", "C", 15, 0, 0, 0, 64, 17, 96
"y:\RAMworkspace\F4Z_test\Middlewares\ST\filex\common\src\fxe_directory_default_get.c", "C", 15, 0, 0, 0, 66, 17, 98
"y:\RAMworkspace\F4Z_test\Middlewares\ST\filex\common\src\fxe_directory_default_get_copy.c", "C", 15, 0, 0, 0, 67, 16, 98
"y:\RAMworkspace\F4Z_test\Middlewares\ST\filex\common\src\fxe_directory_default_set.c", "C", 15, 0, 0, 0, 66, 17, 98
"y:\RAMworkspace\F4Z_test\Middlewares\ST\filex\common\src\fxe_directory_delete.c", "C", 15, 0, 0, 0, 64, 16, 95
"y:\RAMworkspace\F4Z_test\Middlewares\ST\filex\common\src\fxe_directory_first_entry_find.c", "C", 15, 0, 0, 0, 65, 17, 97
"y:\RAMworkspace\F4Z_test\Middlewares\ST\filex\common\src\fxe_directory_first_full_entry_find.c", "C", 18, 0, 0, 0, 74, 17, 109
"y:\RAMworkspace\F4Z_test\Middlewares\ST\filex\common\src\fxe_directory_information_get.c", "C", 21, 0, 0, 0, 74, 17, 112
"y:\RAMworkspace\F4Z_test\Middlewares\ST\filex\common\src\fxe_directory_local_path_clear.c", "C", 16, 0, 0, 0, 62, 15, 93
"y:\RAMworkspace\F4Z_test\Middlewares\ST\filex\common\src\fxe_directory_local_path_get.c", "C", 16, 0, 0, 0, 63, 15, 94
"y:\RAMworkspace\F4Z_test\Middlewares\ST\filex\common\src\fxe_directory_local_path_get_copy.c", "C", 15, 0, 0, 0, 65, 16, 96
"y:\RAMworkspace\F4Z_test\Middlewares\ST\filex\common\src\fxe_directory_local_path_restore.c", "C", 16, 0, 0, 0, 63, 15, 94
"y:\RAMworkspace\F4Z_test\Middlewares\ST\filex\common\src\fxe_directory_local_path_set.c", "C", 16, 0, 0, 0, 67, 15, 98
"y:\RAMworkspace\F4Z_test\Middlewares\ST\filex\common\src\fxe_directory_long_name_get.c", "C", 15, 0, 0, 0, 65, 18, 98
"y:\RAMworkspace\F4Z_test\Middlewares\ST\filex\common\src\fxe_directory_long_name_get_extended.c", "C", 19, 0, 0, 0, 67, 19, 105
"y:\RAMworkspace\F4Z_test\Middlewares\ST\filex\common\src\fxe_directory_name_test.c", "C", 15, 0, 0, 0, 65, 17, 97
"y:\RAMworkspace\F4Z_test\Middlewares\ST\filex\common\src\fxe_directory_next_entry_find.c", "C", 15, 0, 0, 0, 65, 17, 97
"y:\RAMworkspace\F4Z_test\Middlewares\ST\filex\common\src\fxe_directory_next_full_entry_find.c", "C", 18, 0, 0, 0, 74, 17, 109
"y:\RAMworkspace\F4Z_test\Middlewares\ST\filex\common\src\fxe_directory_rename.c", "C", 15, 0, 0, 0, 65, 17, 97
"y:\RAMworkspace\F4Z_test\Middlewares\ST\filex\common\src\fxe_directory_short_name_get.c", "C", 15, 0, 0, 0, 65, 18, 98
"y:\RAMworkspace\F4Z_test\Middlewares\ST\filex\common\src\fxe_directory_short_name_get_extended.c", "C", 19, 0, 0, 0, 67, 19, 105
"y:\RAMworkspace\F4Z_test\Middlewares\ST\filex\common\src\fxe_fault_tolerant_enable.c", "C", 17, 0, 0, 0, 66, 17, 100
"y:\RAMworkspace\F4Z_test\Middlewares\ST\filex\common\src\fxe_file_allocate.c", "C", 15, 0, 0, 0, 64, 17, 96
"y:\RAMworkspace\F4Z_test\Middlewares\ST\filex\common\src\fxe_file_attributes_read.c", "C", 15, 0, 0, 0, 66, 16, 97
"y:\RAMworkspace\F4Z_test\Middlewares\ST\filex\common\src\fxe_file_attributes_set.c", "C", 19, 0, 0, 0, 67, 18, 104
"y:\RAMworkspace\F4Z_test\Middlewares\ST\filex\common\src\fxe_file_best_effort_allocate.c", "C", 15, 0, 0, 0, 67, 17, 99
"y:\RAMworkspace\F4Z_test\Middlewares\ST\filex\common\src\fxe_file_close.c", "C", 15, 0, 0, 0, 63, 17, 95
"y:\RAMworkspace\F4Z_test\Middlewares\ST\filex\common\src\fxe_file_create.c", "C", 15, 0, 0, 0, 64, 17, 96
"y:\RAMworkspace\F4Z_test\Middlewares\ST\filex\common\src\fxe_file_date_time_set.c", "C", 149, 0, 0, 0, 93, 52, 294
"y:\RAMworkspace\F4Z_test\Middlewares\ST\filex\common\src\fxe_file_delete.c", "C", 15, 0, 0, 0, 64, 16, 95
"y:\RAMworkspace\F4Z_test\Middlewares\ST\filex\common\src\fxe_file_extended_allocate.c", "C", 15, 0, 0, 0, 64, 17, 96
"y:\RAMworkspace\F4Z_test\Middlewares\ST\filex\common\src\fxe_file_extended_best_effort_allocate.c", "C", 15, 0, 0, 0, 67, 17, 99
"y:\RAMworkspace\F4Z_test\Middlewares\ST\filex\common\src\fxe_file_extended_relative_seek.c", "C", 20, 0, 0, 0, 73, 18, 111
"y:\RAMworkspace\F4Z_test\Middlewares\ST\filex\common\src\fxe_file_extended_seek.c", "C", 15, 0, 0, 0, 64, 17, 96
"y:\RAMworkspace\F4Z_test\Middlewares\ST\filex\common\src\fxe_file_extended_truncate.c", "C", 15, 0, 0, 0, 64, 17, 96
"y:\RAMworkspace\F4Z_test\Middlewares\ST\filex\common\src\fxe_file_extended_truncate_release.c", "C", 15, 0, 0, 0, 65, 17, 97
"y:\RAMworkspace\F4Z_test\Middlewares\ST\filex\common\src\fxe_file_open.c", "C", 34, 0, 0, 0, 76, 28, 138
"y:\RAMworkspace\F4Z_test\Middlewares\ST\filex\common\src\fxe_file_read.c", "C", 15, 0, 0, 0, 67, 17, 99
"y:\RAMworkspace\F4Z_test\Middlewares\ST\filex\common\src\fxe_file_relative_seek.c", "C", 20, 0, 0, 0, 73, 18, 111
"y:\RAMworkspace\F4Z_test\Middlewares\ST\filex\common\src\fxe_file_rename.c", "C", 15, 0, 0, 0, 65, 17, 97
"y:\RAMworkspace\F4Z_test\Middlewares\ST\filex\common\src\fxe_file_seek.c", "C", 15, 0, 0, 0, 64, 17, 96
"y:\RAMworkspace\F4Z_test\Middlewares\ST\filex\common\src\fxe_file_truncate.c", "C", 15, 0, 0, 0, 64, 17, 96
"y:\RAMworkspace\F4Z_test\Middlewares\ST\filex\common\src\fxe_file_truncate_release.c", "C", 15, 0, 0, 0, 65, 17, 97
"y:\RAMworkspace\F4Z_test\Middlewares\ST\filex\common\src\fxe_file_write.c", "C", 15, 0, 0, 0, 65, 17, 97
"y:\RAMworkspace\F4Z_test\Middlewares\ST\filex\common\src\fxe_file_write_notify_set.c", "C", 15, 0, 0, 0, 66, 16, 97
"y:\RAMworkspace\F4Z_test\Middlewares\ST\filex\common\src\fxe_media_abort.c", "C", 15, 0, 0, 0, 63, 17, 95
"y:\RAMworkspace\F4Z_test\Middlewares\ST\filex\common\src\fxe_media_cache_invalidate.c", "C", 15, 0, 0, 0, 64, 18, 97
"y:\RAMworkspace\F4Z_test\Middlewares\ST\filex\common\src\fxe_media_check.c", "C", 15, 0, 0, 0, 104, 18, 137
"y:\RAMworkspace\F4Z_test\Middlewares\ST\filex\common\src\fxe_media_close.c", "C", 15, 0, 0, 0, 63, 17, 95
"y:\RAMworkspace\F4Z_test\Middlewares\ST\filex\common\src\fxe_media_close_notify_set.c", "C", 15, 0, 0, 0, 66, 16, 97
"y:\RAMworkspace\F4Z_test\Middlewares\ST\filex\common\src\fxe_media_exFAT_format.c", "C", 21, 0, 0, 0, 83, 20, 124
"y:\RAMworkspace\F4Z_test\Middlewares\ST\filex\common\src\fxe_media_extended_space_available.c", "C", 15, 0, 0, 0, 65, 17, 97
"y:\RAMworkspace\F4Z_test\Middlewares\ST\filex\common\src\fxe_media_flush.c", "C", 15, 0, 0, 0, 65, 17, 97
"y:\RAMworkspace\F4Z_test\Middlewares\ST\filex\common\src\fxe_media_format.c", "C", 21, 0, 0, 0, 84, 18, 123
"y:\RAMworkspace\F4Z_test\Middlewares\ST\filex\common\src\fxe_media_open.c", "C", 58, 0, 0, 0, 94, 38, 190
"y:\RAMworkspace\F4Z_test\Middlewares\ST\filex\common\src\fxe_media_open_notify_set.c", "C", 15, 0, 0, 0, 66, 16, 97
"y:\RAMworkspace\F4Z_test\Middlewares\ST\filex\common\src\fxe_media_read.c", "C", 15, 0, 0, 0, 65, 17, 97
"y:\RAMworkspace\F4Z_test\Middlewares\ST\filex\common\src\fxe_media_space_available.c", "C", 15, 0, 0, 0, 65, 17, 97
"y:\RAMworkspace\F4Z_test\Middlewares\ST\filex\common\src\fxe_media_volume_get.c", "C", 15, 0, 0, 0, 68, 18, 101
"y:\RAMworkspace\F4Z_test\Middlewares\ST\filex\common\src\fxe_media_volume_get_extended.c", "C", 19, 0, 0, 0, 70, 19, 108
"y:\RAMworkspace\F4Z_test\Middlewares\ST\filex\common\src\fxe_media_volume_set.c", "C", 15, 0, 0, 0, 65, 18, 98
"y:\RAMworkspace\F4Z_test\Middlewares\ST\filex\common\src\fxe_media_write.c", "C", 15, 0, 0, 0, 65, 18, 98
"y:\RAMworkspace\F4Z_test\Middlewares\ST\filex\common\src\fxe_system_date_get.c", "C", 13, 0, 0, 0, 65, 15, 93
"y:\RAMworkspace\F4Z_test\Middlewares\ST\filex\common\src\fxe_system_date_set.c", "C", 128, 0, 0, 0, 85, 45, 258
"y:\RAMworkspace\F4Z_test\Middlewares\ST\filex\common\src\fxe_system_time_get.c", "C", 13, 0, 0, 0, 65, 15, 93
"y:\RAMworkspace\F4Z_test\Middlewares\ST\filex\common\src\fxe_system_time_set.c", "C", 21, 0, 0, 0, 69, 17, 107
"y:\RAMworkspace\F4Z_test\Middlewares\ST\filex\common\src\fxe_unicode_directory_create.c", "C", 22, 0, 0, 0, 69, 18, 109
"y:\RAMworkspace\F4Z_test\Middlewares\ST\filex\common\src\fxe_unicode_directory_rename.c", "C", 31, 0, 0, 0, 72, 20, 123
"y:\RAMworkspace\F4Z_test\Middlewares\ST\filex\common\src\fxe_unicode_file_create.c", "C", 22, 0, 0, 0, 68, 19, 109
"y:\RAMworkspace\F4Z_test\Middlewares\ST\filex\common\src\fxe_unicode_file_rename.c", "C", 32, 0, 0, 0, 71, 20, 123
"y:\RAMworkspace\F4Z_test\Middlewares\ST\filex\common\src\fxe_unicode_name_get.c", "C", 17, 0, 0, 0, 67, 18, 102
"y:\RAMworkspace\F4Z_test\Middlewares\ST\filex\common\src\fxe_unicode_name_get_extended.c", "C", 21, 0, 0, 0, 70, 19, 110
"y:\RAMworkspace\F4Z_test\Middlewares\ST\filex\common\src\fxe_unicode_short_name_get.c", "C", 23, 0, 0, 0, 69, 18, 110
"y:\RAMworkspace\F4Z_test\Middlewares\ST\filex\common\src\fxe_unicode_short_name_get_extended.c", "C", 27, 0, 0, 0, 71, 19, 117
"y:\RAMworkspace\F4Z_test\Middlewares\ST\filex\ports\generic\inc\fx_port.h", "C", 96, 0, 0, 0, 77, 50, 223
"y:\RAMworkspace\F4Z_test\STM32F407ZGTX_FLASH.ld", "LinkerScript", 0, 127, 0, 0, 53, 27, 207
"y:\RAMworkspace\F4Z_test\STM32F407ZGTX_RAM.ld", "LinkerScript", 0, 137, 0, 0, 53, 28, 218
"y:\RAMworkspace\F4Z_test\bsp\CalcluateString.c", "C", 47, 0, 0, 0, 20, 7, 74
"y:\RAMworkspace\F4Z_test\bsp\GetRunTime.c", "C", 8, 0, 0, 0, 15, 1, 24
"y:\RAMworkspace\F4Z_test\bsp\GetRunTime.h", "C", 11, 0, 0, 0, 11, 3, 25
"y:\RAMworkspace\F4Z_test\bsp\GetTime.h", "C", 24, 0, 0, 0, 14, 5, 43
"y:\RAMworkspace\F4Z_test\bsp\PrintArray.c", "C", 32, 0, 0, 0, 16, 6, 54
"y:\RAMworkspace\F4Z_test\bsp\PrintArray.h", "C", 2, 0, 0, 0, 6, 2, 10
"y:\RAMworkspace\F4Z_test\bsp\PrintError.h", "C", 32, 0, 0, 0, 15, 5, 52
"y:\RAMworkspace\F4Z_test\bsp\printf.c", "C", 653, 0, 0, 0, 150, 118, 921
"y:\RAMworkspace\F4Z_test\bsp\printf.h", "C", 23, 0, 0, 0, 74, 21, 118
"y:\RAMworkspace\F4Z_test\show_stype_size.c", "C", 0, 0, 0, 0, 106, 8, 114
"y:\RAMworkspace\F4Z_test\tree1.c", "C", 58, 0, 0, 0, 10, 11, 79
"y:\RAMworkspace\F4Z_test\tree2.c", "C", 90, 0, 0, 0, 11, 17, 118
"y:\RAMworkspace\F4Z_test\tree3.c", "C", 118, 0, 0, 0, 18, 18, 154
"Total", "-", 28408, 264, 398, 83, 27966, 12608, 69727